07-17, 03-01
############6### 
#              #
#              #
1              #
#              #
#      k       #
################