11-17, 01-07
#######1#########
#               #
#               #
#   k           #
#               #
#               5
#               #
#               #
#         n     #
#               #
#################