20-10, 07-08
##########
#       ##
###      #
##k#     #
#####    #
###     ##
###      #
##  # #  1
##       #
##       #
#   #    #
### #    #
# ##     #
##       #
#        #
###      #
#D### ####
##  #### #
###      #  
##########