10-09, 01-01
#########
3       #
#       #
#       #
#     ###
#     |T#
#     ###
#       #
#       #
#########